xmxxxxxxxxxxxxx
x0x0000x000000x
x0x0x0xxxxx0X0x
x000xxx000x0x0x
x0x000x0x0x000x
x0xxx000x0x0x0x
x00000xxx000x0x
xxx0x0x0xxx0xxx
x0x0x000x000x0x
x0x0xxx0xx0xx0x
x00000x0x00x00x
x0xxx0x0x0xxx0g
x0x0x0x0x0xx00x
x000x000x0000xx
xxxxxxxxxxxxxxx